138,300,1,0
0,0,D,0,0,0,0
0,0,0,0,0,L,0
0,0,0,0,0,0,0
D,0,0,D,0,0,0
0,0,0,0,0,0,0
0,L,0,0,0,0,0
