138,175,1,1
X,D,D,D,L,D,X
D,B,0,S,S,B,D
X,D,0,P,0,D,X
X,X,D,0,D,X,X
X,X,X,D,X,X,X
X
X
X
X
X
X
X
X
X,X,X,D,X,X,X
X,X,D,0,D,X,X
X,D,0,P,0,D,X
D,B,0,S,S,B,D
X,D,D,D,L,D,X
